********************
*       *          *
*       *      E   *
*       *          *
*        *         *
*  S     *         *
*        *         *
*        *         *
********************
