********************
*              *   *
*  ******** ****   *
*  *     E* *      *
*  *  *******   *  *
*  *   *    * * *  *
*  *            *  *
*S ***********  *  *
*                  *
********************
