********************
*                  *
* **************** *
*S*              * *
*E*              * *
* *              * *
* **************** *
*                  *
********************
